3            N
1            Y
2            Y
5            N
6            N
7            N
8            N
4            Y
